[{
  "title": "Simple",
  "colors": ["#222", "#3BA"],
  "solution": [
    [-1, -1, -1, -1, -1, -1, -1],
    [-1, -1, -1, -1, -1, -1, -1],
    [-1, -1, 1, 0, 1, -1, -1],
    [-1, -1, 0, 0, 0, -1, -1],
    [-1, -1, 1, 0, 1, -1, -1],
    [-1, -1, -1, -1, -1, -1, -1],
    [-1, -1, -1, -1, -1, -1, -1]
  ]
}, {
  "title": "Still Life",
  "colors": ["#E31", "#0D0", "#FF1"],
  "solution": [
    [-1, -1, -1, -1, -1, -1, -1],
    [-1, -1, -1, -1, -1, -1, -1],
    [-1, 2, -1, -1, -1, -1, -1],
    [2, 2, -1, 0, 0, -1, -1],
    [2, 2, 0, 0, 0, 0, 1],
    [2, 2, 2, 0, 0, 1, 1],
    [-1, 2, 2, 0, 0, 0, 1]
  ]
}, {
  "title": "Support",
  "colors": ["#DA1", "#455"],
  "solution": [
    [1, 1, 1, 1, 1, 1],
    [1, 1, 1, 1, 1, 1],
    [-1, 1, 1, 1, 1, -1],
    [-1, -1, 1, 1, -1, -1],
    [-1, -1, 0, 0, -1, -1],
    [-1, 0, 0, 0, 0, -1]
  ]
}, {
  "title": "Wabbit",
  "colors": ["#200", "#BDE"],
  "solution": [
    [-1, -1, -1, 0, -1, -1, 0, -1, -1, -1, -1, -1, -1, -1],
    [-1, -1, 0, 0, 0, -1, 0, 0, -1, -1, -1, -1, -1, -1],
    [-1, -1, 0, -1, 0, -1, 0, 0, -1, -1, -1, -1, -1, -1],
    [-1, -1, 0, -1, 0, 0, 0, 0, -1, -1, -1, -1, -1, -1],
    [-1, 0, -1, -1, -1, -1, 1, 1, 0, -1, -1, -1, -1, -1],
    [0, 0, -1, 0, -1, -1, -1, 1, 0, 0, 0, -1, -1, -1],
    [0, -1, -1, 0, -1, -1, -1, 1, 1, 1, -1, 0, -1, 0],
    [0, -1, -1, -1, -1, -1, 1, -1, -1, -1, 1, 1, 0, -1],
    [-1, 0, 0, -1, -1, 1, -1, -1, -1, 1, -1, 1, 1, 0],
    [-1, -1, -1, 0, 1, -1, -1, 1, 1, -1, -1, -1, 1, 0],
    [-1, -1, 0, -1, 1, -1, -1, 1, -1, -1, 0, 0, 1, 0],
    [-1, 0, 0, -1, -1, -1, 0, 0, 0, 0, -1, 1, 1, 0],
    [-1, 0, -1, -1, 0, 0, -1, -1, -1, -1, -1, -1, -1, 0],
    [-1, 0, 0, 0, -1, 0, 0, 0, 0, 0, 0, 0, 0, -1]
  ]
}, {
  "title": "Charblander",
  "colors": ["#200", "#F80", "#F60", "#FE0", "#ED0", "#D01"],
  "solution": [
    [-1, -1, -1, -1, 0, 0, 0, 0, -1, -1, -1, -1, -1, -1, -1, -1, 0, -1],
    [-1, -1, -1, -1, -1, -1, -1, -1, -1, 0, 1, 1, 1, 2, 0, -1, -1, -1],
    [-1, -1, -1, 0, 5, 0, -1, -1, -1, -1, -1, -1, -1, -1, 0, 1, 1, 1],
    [1, 1, 2, 0, -1, -1, -1, -1, -1, 0, 5, 5, 0, -1, -1, -1, -1, -1],
    [-1, -1, 0, 1, 1, 1, 1, 1, 1, 0, -1, -1, -1, -1, -1, 0, 5, 5],
    [0, -1, -1, -1, -1, -1, -1, 0, 1, 1, 1, 1, 1, 1, 1, 2, 0, -1],
    [-1, -1, 0, 5, 5, 5, 5, 0, -1, -1, -1, -1, 0, 1, 1, 1, 1, -1],
    [0, 1, 1, 2, 0, -1, -1, -1, 0, 5, 5, 3, 5, 0, -1, -1, -1, -1],
    [0, 1, 1, 1, 1, 0, 0, 1, 2, 2, 2, 0, -1, -1, 0, 5, 3, 3],
    [5, 0, -1, -1, -1, -1, 0, 1, 1, 1, 1, 0, 0, 1, 2, 2, 2, 0],
    [-1, -1, -1, 0, 3, 0, 0, -1, -1, -1, -1, -1, -1, 0, 0, 2, 1, 1],
    [1, 2, 2, 2, 2, 2, 0, 0, -1, 0, 1, 0, -1, -1, -1, -1, -1, -1],
    [-1, -1, -1, 0, 0, 0, 2, 2, 0, 2, 2, 2, 2, 0, 0, 1, 1, 0],
    [-1, -1, -1, -1, -1, -1, -1, -1, -1, -1, 0, 3, 3, 0, 2, 2, 2, 2],
    [2, 0, 2, 1, 0, -1, -1, -1, -1, -1, -1, -1, -1, -1, -1, -1, 0, 3],
    [3, 3, 0, 0, 2, 2, 2, 0, 2, 1, 0, -1, -1, -1, -1, -1, -1, -1],
    [-1, -1, -1, 0, -1, 0, 3, 3, 3, 2, 2, 2, 2, 0, 2, 0, -1, -1],
    [-1, -1, -1, -1, -1, -1, -1, -1, -1, -1, 0, 0, 0, 4, 4, 2, 2, 2],
    [2, 0, 0, -1, -1, -1, -1, -1, -1, -1, -1, -1, -1, -1, -1, -1, -1, -1],
    [-1, 0, 0, 0, 2, 0, 0, 0, -1, -1, -1, -1, -1, -1, -1, -1, -1, -1],
    [-1, -1, -1, -1, -1, -1, -1, -1, 0, -1, 2, -1, 0, -1, -1, -1, -1, -1],
    [-1, -1, -1, -1, -1, -1, -1, -1, -1, -1, -1, -1, -1, -1, 0, 0, 0, 0],
    [0, -1, -1, -1, -1, -1, -1, -1, -1, -1, -1, -1, -1, -1, -1, -1, -1, -1],
    [-1, -1, -1, -1, -1, -1, -1, -1, -1, -1, -1, -1, -1, -1, -1, -1, -1, -1]
  ]
}]